11111111111111111
10000000000000001
100000000000E0001
10000000011010001
101111111111C1111
10000000111111111
11111110000000001
11111111111111111