1111111111
100C0000C1
110C011101
1P101110E0
1111111111