1111111111
100C0000C1
1C0C011101
1P0011E001
1111111111