11111111111111111
1P00000000E000001
10000000000000001
1000000C011000001
10001010111111111
10000000111111111
11111110000000001
10000000000000001
11111111111111111