1111111111
100C0000C1
100C011101
1P101110E1
1111111111