11111111111111111
10P00000000000001
100000000000E0001
100000000110100C1
10111111111111111
10000000111111111
11111110000000001
11111111111111111