11111111111111111
1P0C00000000000C1
100C0111000000001
10111111E10000001
10100000000010001
10100000C00010001
10100000C00010001
10100000000010001
10000000000010001
11111111111111111