11111111111111111
100C00000000000C1
100C0111000000001
10111110E00000001
1010000P100010001
10100000000010001
10100000000010001
10100000000010001
10000000000010001
11111111111111111