11111111111111111
1P00000000E000001
10000000000000001
10000000011000001
10111111111111111
10000000111111111
111111100000000C1
11111111111111111