11111111111111111
100C00000000000C1
100C0111000000001
10101110E00000001
1000000P000010001
10000000000010001
10000000000010001
10000000000010001
10000000000010001
11111111111111111